8 16
1111111111111111
1222222222222221
1221222122212221
1212212221222121
1221222122212221
1212212221222121
1221222122212221
1111111111111111
