28 44
00000000000000111111111111110000000000000000
00000000000000122222222222210000000000000000
00000000000000122222222222210000000000000000
00000000000000122222222222210000000000000000
00000000000000122222222222210000000000000000
00000000000000122222222222210000000000000000
00000011111111122222222222211111111100000000
00000012222222222222222222222222222100000000
00000012222222222222222222222222222100000000
00000012222222222222222222222222222100000000
00000012222222222222222222222222222100000000
11111112222222222222222222222222222111111111
12222222222222222222222222222222222222222221
12222222222222222222222222222222222222222221
12222222222222222222222222222222222222222221
12222222222222222222222222222222222222222221
12222222222222222222222222222222222222222221
12222222222222222222222222222222222222222221
12222222222222222222222222222222222222222221
12222222222222222222222222222222222222222221
11111112222222222222222222222222222111111111
00000012222222222222222222222222222100000000
00000012222222222222222222222222222100000000
00000012222222222222222222222222222100000000
00000011111122222222222222221111111100000000
00000000000122222222222222221000000000000000
00000000000122222222222222221000000000000000
00000000000111111111111111111000000000000000 

