16 32
11111111111111111111111111111111
12222222222222222222222222222221
12222222222222222222222222222221
12222222222222222222222222222221
12222222222222222222222222222221
12222222222222222222222222222221
12222222222222222222222222222221
12222222222222222222222222222221
12222222222222222222222222222221
11111111111111111112222222222221
00000000000000000012222222222221
00000000000000000012222222222221
00000000000000000012222222222221
00000000000000000012222222222221
00000000000000000012222222222221
00000000000000000011111111111111